7 10 13 12 1 11 5 4 2 8
7 10 13 12 11 1 5 4 2
7 10 12 13 11 1 5 4 2
7 10 13 12 1 11 5 4 2
7 10 12 13 11 1 5 4 2
7 10 13 12 11 1 5 2 4
7 10 13 12 11 1 5 4 2
7 10 13 12 11 1 5 4
7 10 12 13 1 11 5 4 2
7 10 13 12 11 1 5 4
