1 2 3 4 7 8 10 11 12 13
1 2 3 4 5 6 7 10 11 12 13
1 2 3 4 5 7 10 11 12 13
1 2 3 4 5 7 9 10 11 12 13
1 2 3 4 5 7 10 11 12 13
1 2 3 4 5 7 10 11 12 13
1 2 3 4 5 7 10 11 12 13
1 2 3 4 5 7 8 10 11 12 13
1 3 4 5 6 7 10 11 12 13
1 3 4 5 7 10 11 12 13
