1 2 3 4 7 10 11 12 13
1 2 3 4 5 7 10 11 12 13
1 2 3 4 5 7 10 11 12 13
1 2 3 4 5 7 10 11 12 13
1 3 4 5 7 10 11 12 13
1 3 4 5 7 10 11 12 13
1 3 4 5 7 10 11 13
1 3 4 5 7 10 11 12 13
1 3 4 5 7 10 11 12 13
1 3 4 5 7 10 11 12 13
