7 12 10 13 1 11 6 5 4 8 2 9 3
7 12 10 13 1 6 11 5 4 2 9 8 3
7 12 10 13 11 1 6 5 9 4 2 8 3
7 10 12 13 1 11 6 5 4 9 2 8 3
7 10 12 13 11 1 6 5 9 4 8 2 3
7 12 13 10 6 1 11 5 9 2 4 8 3
7 12 10 13 1 11 6 5 8 9 4 2 3
7 10 12 13 6 1 11 5 9 4 2 8 3
7 12 10 13 1 6 11 5 9 4 2 8 3
7 12 10 13 1 11 6 5 9 4 8 2 3
